M M M M M M M M M M M M M M M 
M S M S S S M S S S S S S S M
M S M S M S M S M M M M M M M
M S M M M S S S M S S S S S M
M S S S M S M S M S M M M S M
M S M S M S M S M S M S S M M
M S M S M S M M M S M M S M M
M S M M M S S S S S S M S S M
M S S S S S M M M M M M M S M
M M M M M S S S S S S S S S M
M S S S M S M M M M M S M S M
M S M S S S M S S M S S M S M
M S M M S M M M S M S M M S M
M S S M S S S S S S S S M S M
M M M M M M M M M M M M M M M 

Mac Gyver	1	1
Keeper	13	13	needle	pipe	syringe	

needle
pipe
syringe
